0,0,0,21,29,29,29,0,0,0
0,0,2,22,0,0,0,0,0,0
0,1,0,24,23,0,0,0,0,0
0,0,0,12,22,0,0,3,0,0
0,0,0,4,22,0,0,0,0,0
0,0,0,0,24,24,7,7,0,0
0,0,0,2,0,0,7,7,0,0
0,0,0,0,14,15,16,17,18,19
0,0,0,0,0,0,0,0,0,0
0,0,0,0,32,33,0,35,36,0
