0,13,14,15,16,17,18,19,20,21
0,7,0,24,24,0,0,6,0,0
0,0,0,0,0,0,0,0,0,0
0,0,0,0,0,0,0,0,0,0
0,0,0,0,0,0,0,0,0,0
0,0,0,0,0,5,0,0,0,0
0,0,0,0,0,0,0,13,23,16
0,0,3,0,0,4,0,21,0,22
32,33,0,0,0,0,0,21,0,22
2,0,1,0,0,0,0,17,24,18
