1,2,3,4,3,2,1,1,2,3
1,1,1,1,1,3,4,3,2,1
1,2,3,4,3,2,1,1,2,3
1,1,1,1,1,3,4,3,2,1
1,2,3,4,0,2,1,1,2,3
1,1,1,1,1,3,4,3,2,1
1,2,3,4,3,2,1,1,2,3
1,1,1,1,1,3,4,3,2,1
1,2,3,4,3,2,1,1,2,3
1,1,1,1,1,3,4,3,2,1
