0,13,14,15,16,17,18,19,20,21
0,7,0,0,0,0,0,6,0,0
0,0,15,24,14,0,0,0,0,0
0,0,22,0,0,0,13,23,16,0
0,0,19,24,14,0,21,0,22,0
0,0,0,0,21,5,17,24,18,0
0,0,0,23,20,0,0,0,0,0
0,0,3,0,29,4,29,0,0,0
32,33,0,0,0,0,0,0,0,0
2,0,0,0,0,0,0,0,0,0
