0,13,14,15,16,17,18,19,20,21
0,7,0,0,0,0,0,6,0,0
0,0,0,0,0,0,0,0,0,0
0,0,0,0,0,0,0,0,0,0
0,0,0,0,0,0,0,0,0,0
0,0,0,0,0,5,0,0,0,0
0,0,0,0,0,0,0,0,0,0
0,0,3,0,0,4,0,0,0,0
32,33,0,0,0,0,0,0,0,0
2,0,0,0,0,0,0,0,0,0
