13,14,15,16,17,18,19,20,21,22
23,24,25,14,14,14,14,14,14,14
14,14,14,14,14,14,14,14,14,14
14,14,14,14,14,14,14,14,14,14
14,14,14,14,14,14,14,14,14,14
14,14,14,14,14,14,14,14,14,14
14,14,14,14,14,14,14,14,14,14
14,14,14,14,14,14,29,14,14,14
14,14,32,33,14,14,14,14,14,14
0,0,0,3,4,5,6,7,0,0
