13,0,15,16,17,18,19,20,21,22
23,24,25,0,0,0,0,0,0,0
0,0,0,0,0,0,0,0,0,0
0,0,0,0,0,0,0,0,0,0
0,0,0,0,0,0,0,0,0,0
0,0,0,0,0,0,0,0,0,0
0,0,0,0,0,0,0,0,0,0
0,0,0,0,29,0,29,0,0,0
32,33,0,0,0,0,0,0,0,0
2,0,3,1,4,5,6,7,0,0
