0,13,23,23,23,16,0,0,0,0
24,25,25,24,24,18,0,0,0,0
0,0,0,0,0,0,0,0,0,0
0,0,0,0,0,0,0,0,0,0
0,0,15,0,0,0,0,0,0,0
0,0,22,0,0,0,0,0,0,0
0,0,0,0,0,0,0,0,0,0
0,0,0,0,29,0,29,0,0,0
32,33,0,0,0,0,0,0,0,0
2,0,3,1,4,5,6,7,0,0
