0,13,14,15,16,17,18,19,20,21
0,0,0,0,0,0,0,0,0,0
0,0,0,0,0,0,0,0,0,0
0,0,0,0,0,0,0,0,0,0
0,0,15,24,14,0,13,23,16,0
0,0,22,0,21,0,21,0,22,0
0,0,19,23,20,0,17,24,18,0
0,0,0,0,29,0,29,0,0,0
32,33,0,0,0,0,0,0,0,0
2,0,3,1,4,5,6,7,0,0
